29.ox
.o.oooo.
..oo.ooo
o.oo.ooo
oooooo..
ooo..ooo
o....o.o
ooo.oooo
.oo.o.oo
.oo.oo..
ooo.....
o...o..o
oo..o.o.
.o.ooooo
o..oooo.
.ooooo..
oooooooo
...o.ooo
ooo.ooo.
oo.ooo.o
o..o.oo.
..o.oooo
o.oo.oo.
o..ooo.o
oo..oo.o
oooooo.o
o..oooo.
oo.ooooo
oo.oo.o.
..oo..o.
