25.ox
o.....o..o.
o.........o
....o..o...
...o.oooo..
..o..o..o..
o.ooo...o.o
.....o.....
....oooo..o
.o..o.o.oo.
...o....o..
..o....o...
......ooo..
o.o........
...ooo.....
..o.o...o..
........o..
...o.......
...........
...o..o.o..
..o..o.o...
.o......o.o
.ooooo.o...
.......o.o.
.o...ooo...
......o.oo.
