8.ox
..oo.......o.
.............
oooo.oo.oo.oo
......oo..o..
o.o....o...o.
o.o..o..o..o.
o....o.o.o...
.oo...o.o.ooo
