21.ox
.o..oooo.....o
oo...o.o......
oo..o.oo..oooo
.o.o.ooo.ooo..
ooo......o.ooo
...o...oo.o.o.
o.oo.o.ooo....
o.o..o.ooo..oo
...o.o.ooo...o
o.o.o.oo...oo.
..ooo.oo..oo..
o.oo.o.oooo.o.
oo..o....o..oo
o.......oooo..
oo..o.oo..o.oo
o.....oooo..oo
o.o..ooo.ooooo
.o..o..oo.o...
.o..o...oooo.o
o.o.oo.....o.o
.o...o....oo.o
