28.ox
...o.oooooooo.o
oo.o...ooo.o.oo
...o.....o..oo.
.oo..o.o....oo.
oo..o.....oo..o
..ooo.oo......o
ooooo....ooo...
....oo.o..o...o
........oo....o
oooooo..oo.o.o.
oo.........o...
oooo..ooo.o.ooo
......oo....o..
oo.oo....ooooo.
....o.o..o....o
..oo.o.o.o.ooo.
.oooooooooo..oo
..o.o..oo....o.
.o.....o.o..o.o
...ooo..o..o...
oo.....oo.o.o..
..oo...o..o.ooo
oo.o..o......oo
oo.ooo..ooo....
o..o.o..o.o....
oooo.o..oo.o.oo
o..oo...oo..oo.
o....o.o...o.oo
