25.ox
ooo...o.oooo....
..ooo..oooo....o
.oo.oo....ooo.oo
..o.oo.o........
.ooooo.....o...o
o..o.ooo.o.oo.o.
.oo.ooo.o....o.o
......oo.o.ooo..
..ooo..oooo.o..o
.oo.oooo..o.o.o.
.oo....o.oo...o.
.o.o..ooo.oo.ooo
....o.oo.oo....o
..oo..oo..ooo.o.
..oo..o.oooo..o.
oo.o...oo..o..o.
..ooo..o.....oo.
.o..oooo..o..o.o
..o...o.oo...oo.
.......oooo.oooo
oo..o..o.o..oo..
o.....o.o.oo.ooo
o.o..o.o..o.....
o....o..oo..ooo.
...oo.oo.o.oo..o
